{
  "player_spawn": [10, 10],

  "rooms": [
    {
      "grid": [
        [2, 2, 2, 2, 2, 2, 2, 2, 2, 0, 0, 2, 2, 2, 2, 2, 2, 2, 2, 2],
        [2, 0, 0, 0, 0, 0, 0, 0, 0, 0, 0, 0, 0, 0, 0, 0, 0, 0, 0, 2],
        [2, 0, 0, 0, 0, 0, 0, 0, 0, 0, 0, 0, 0, 0, 0, 0, 0, 0, 0, 2],
        [2, 0, 0, 0, 0, 0, 2, 0, 0, 0, 0, 0, 0, 2, 0, 0, 0, 0, 0, 2],
        [2, 0, 0, 0, 0, 0, 0, 0, 0, 0, 0, 0, 0, 2, 0, 0, 0, 0, 0, 2],
        [2, 0, 0, 0, 0, 0, 2, 0, 0, 0, 0, 0, 0, 2, 0, 0, 0, 0, 0, 2],
        [2, 0, 0, 0, 0, 0, 2, 0, 0, 0, 0, 0, 0, 0, 0, 0, 0, 0, 0, 2],
        [2, 0, 0, 0, 0, 0, 2, 0, 0, 0, 0, 0, 0, 2, 0, 0, 0, 0, 0, 2],
        [2, 0, 0, 0, 0, 0, 0, 0, 0, 0, 0, 0, 0, 2, 0, 0, 0, 0, 0, 2],
        [2, 0, 0, 0, 0, 0, 2, 0, 0, 0, 0, 0, 0, 2, 0, 0, 0, 0, 0, 2],
        [2, 0, 0, 0, 0, 0, 2, 0, 0, 0, 0, 0, 0, 0, 0, 0, 0, 0, 0, 2],
        [2, 0, 0, 0, 0, 0, 2, 0, 0, 0, 0, 0, 0, 2, 0, 0, 0, 0, 0, 2],
        [2, 0, 0, 0, 0, 0, 0, 0, 0, 0, 0, 0, 0, 0, 0, 0, 0, 0, 0, 2],
        [2, 0, 0, 0, 0, 0, 0, 0, 0, 0, 0, 0, 0, 0, 0, 0, 0, 0, 0, 2],
        [2, 2, 2, 2, 2, 2, 2, 2, 2, 2, 2, 2, 2, 2, 2, 2, 2, 2, 2, 2]
      ],

      "doors": [
        {
          "id": 1,
          "to_room": -1,
          "tiles": [[9, 0], [10, 0]],
          "trigger": "UP"
        }
      ],

      "enemies": [
        {
          "type": "TURRET",
          "spawn": [1, 4],
          "direction": "RIGHT"
        },
        {
          "type": "TURRET",
          "spawn": [18, 6],
          "direction": "LEFT"
        },
        {
          "type": "TURRET",
          "spawn": [1, 8],
          "direction": "RIGHT"
        },
        {
          "type": "TURRET",
          "spawn": [18, 10],
          "direction": "LEFT"
        },
        {
          "type": "DRONE",
          "spawn": [8, 11],
          "targets": [[8, 11], [8, 3], [11, 3], [11, 11]]
        }
      ]
    }
  ]
}