{
    "player_spawn": [9, 12],

    "rooms": [
        {
            "announcement": "Move with WASD!",
            "grid": [
                [2, 2, 2, 2, 2, 2, 2, 2, 2, 0, 0, 2, 2, 2, 2, 2, 2, 2, 2, 2],
                [2, 0, 0, 0, 0, 0, 0, 0, 0, 0, 0, 0, 0, 0, 0, 0, 0, 0, 0, 2],
                [2, 0, 0, 0, 0, 0, 0, 0, 0, 0, 0, 0, 0, 0, 0, 0, 0, 0, 0, 2],
                [2, 0, 0, 0, 0, 1, 2, 2, 2, 0, 0, 2, 2, 2, 1, 0, 0, 0, 0, 2],
                [2, 0, 0, 0, 0, 1, 2, 0, 0, 0, 0, 0, 0, 2, 1, 0, 0, 0, 0, 2],
                [2, 0, 0, 0, 0, 1, 2, 0, 0, 0, 0, 0, 0, 2, 1, 0, 0, 0, 0, 2],
                [2, 0, 0, 0, 0, 1, 2, 0, 0, 0, 0, 0, 0, 2, 1, 0, 0, 0, 0, 2],
                [2, 0, 0, 0, 0, 1, 2, 0, 0, 0, 0, 0, 0, 2, 1, 0, 0, 0, 0, 2],
                [2, 0, 0, 0, 0, 1, 2, 0, 0, 0, 0, 0, 0, 2, 1, 0, 0, 0, 0, 2],
                [2, 0, 0, 0, 0, 1, 2, 0, 0, 0, 0, 0, 0, 2, 1, 0, 0, 0, 0, 2],
                [2, 0, 0, 0, 0, 1, 2, 0, 0, 0, 0, 0, 0, 2, 1, 0, 0, 0, 0, 2],
                [2, 0, 0, 0, 0, 1, 2, 2, 2, 0, 0, 2, 2, 2, 1, 0, 0, 0, 0, 2],
                [2, 0, 0, 0, 0, 0, 0, 0, 0, 0, 0, 0, 0, 0, 0, 0, 0, 0, 0, 2],
                [2, 0, 0, 0, 0, 0, 0, 0, 0, 0, 0, 0, 0, 0, 0, 0, 0, 0, 0, 2],
                [2, 2, 2, 2, 2, 2, 2, 2, 2, 2, 2, 2, 2, 2, 2, 2, 2, 2, 2, 2]
            ],
            "doors": [
                {
                    "id": 1,
                    "to_room": 1,
                    "tiles": [[9, 0], [10, 0]]
                }
            ],
            "enemies": [
            ]
        },
        {
            "announcement": "Avoid the Drones!",
            "grid": [
                [2, 2, 2, 2, 2, 2, 2, 2, 2, 0, 0, 2, 2, 2, 2, 2, 2, 2, 2, 2],
                [2, 0, 0, 0, 0, 0, 0, 0, 0, 0, 0, 0, 0, 0, 0, 0, 0, 0, 0, 2],
                [2, 0, 0, 0, 0, 0, 0, 0, 0, 0, 0, 0, 0, 0, 0, 0, 0, 0, 0, 2],
                [2, 0, 0, 0, 0, 0, 0, 0, 0, 0, 0, 0, 0, 0, 0, 0, 0, 0, 0, 2],
                [2, 0, 0, 0, 0, 0, 0, 0, 0, 0, 0, 0, 0, 0, 0, 0, 0, 0, 0, 2],
                [2, 0, 0, 0, 0, 0, 0, 0, 0, 0, 0, 0, 0, 0, 0, 0, 0, 0, 0, 2],
                [2, 0, 0, 0, 0, 0, 0, 0, 0, 0, 0, 0, 0, 0, 0, 0, 0, 0, 0, 2],
                [2, 0, 0, 0, 0, 0, 0, 0, 0, 0, 0, 0, 0, 0, 0, 0, 0, 0, 0, 2],
                [2, 0, 0, 0, 0, 0, 0, 0, 0, 0, 0, 0, 0, 0, 0, 0, 0, 0, 0, 2],
                [2, 0, 0, 0, 0, 0, 0, 0, 0, 0, 0, 0, 0, 0, 0, 0, 0, 0, 0, 2],
                [2, 0, 0, 0, 0, 0, 0, 0, 0, 0, 0, 0, 0, 0, 0, 0, 0, 0, 0, 2],
                [2, 0, 0, 0, 0, 0, 0, 0, 0, 0, 0, 0, 0, 0, 0, 0, 0, 0, 0, 2],
                [2, 0, 0, 0, 0, 0, 0, 0, 0, 0, 0, 0, 0, 0, 0, 0, 0, 0, 0, 2],
                [2, 0, 0, 0, 0, 0, 0, 0, 0, 0, 0, 0, 0, 0, 0, 0, 0, 0, 0, 2],
                [2, 2, 2, 2, 2, 2, 2, 2, 2, 0, 0, 2, 2, 2, 2, 2, 2, 2, 2, 2]
            ],
            "doors": [
                {
                    "id": 1,
                    "to_room": 0,
                    "tiles": [[9, 14], [10, 14]]
                }
            ],
            "elevator": {
                "tiles": [[9, 0], [10, 0]],
                "to_floor": 2
            },
            "enemies": [
                {
                    "type": "TURRET",
                    "spawn": [1, 4],
                    "direction": "RIGHT"
                },
                {
                    "type": "TURRET",
                    "spawn": [18, 4],
                    "direction": "LEFT"
                },
                {
                    "type": "DRONE",
                    "spawn": [2, 2],
                    "targets": [[2, 2], [17, 2]]
                },
                {
                    "type": "DRONE",
                    "spawn": [4, 6],
                    "targets": [[4, 6], [17, 6]]
                },
                {
                    "type": "DRONE",
                    "spawn": [6, 9],
                    "targets": [[6, 9], [17, 9]]
                },
                {
                    "type": "DRONE",
                    "spawn": [8, 12],
                    "targets": [[8, 12], [17, 12]]
                }
            ]
        }
    ]
}